HuB2013__Rhinolophus_sinicus	RVTPTQEVVRFPNITNRCPFDRVFNASRFPSVYAWERTKISDCVADYTVLYNS-TSFSTFKCYGVSPSKLIDLCFTSVYADTFLIRSSEVRQVAPGETGVIADYNYKLPDDFTGCVIAWNTAKQDT-----GYYYYRSHRKTKLKPFERDLSSDD-------------GNGVYTLSTYDFN-PNVPVAYQATRVVVLSFELLNAPATVCGPKLSTELVKNQCVNF
Rs806/2006__Rhinolophus_sinicus	RVSPTQEVVRFPNITNRCPFDKVFNATRFPNVYAWERTKISDCVADYTVLYNS-TSFSTFKCYGVSPSKLIDLCFTSVYADTFLIRSSEVRQVAPGETGVIADYNYKLPDDFTGCVIAWNTAKQDT-----GNYYYRSHRKTKLKPFERDLSSDD--------------DGVYTLSTYDFN-PNVPVAYQATRVVVLSFELLNAPATVCGPKLSTQLVKNQCVNF
BtRI-SC2018__Rhinolophus	RVSPTQEVVRFPNITNRCPFDKVFNASRFPSVYAWERIKISDCVADYTVLYNS-TSFSTFKCYGVSPSKLIDLCFTSVYADTFLIRSSEVRQVAPGETGVIADYNYKLPDDFTGCVIAWNTAKQDT-----GSYYYRSHRKTKLKPFERDLSSDD-------------GNGVYTLSTYDFN-PNVPVAYQATRVVVLSFELLNAPATVCGPKLSTQLVKNQCVNF
HKU3-8__Rhinolophus_sinicus	RVSPTQEVIRFPNITNRCPFDRVFNASRFPSVYAWERTKISECVADYTVLYNS-TSFSTFKCYGVSPSKLIDLCFTSVYADTFLIRSSEVRQVAPGETGVIADYNYKLPDDFTGCVIAWNTAKQDT-----GNYYYRSHRKTKLKPFERDLSSDD-------------GNGVYTLSTYDFN-PNVPVAYQATRVVVLSFELLNAPATVCGPKLSTQLVKNQCVNF
Longquan-140__Rhinolophus_monoceros	RVSPTQEVIRFPNITNRCPFDKVFNVTRFPNVYAWERTKISDCVADYTVLYNS-TSFSTFKCYGVSPSKLIDLCFTSVYADTFLIRSSEVRQVAPGETGVIADYNYKLPDDFTGCVIAWNTAKQDI-----GNYYYRSHRKTKLKPFERDLSSDD-------------GNGVYTLSTYDFN-PNVPVAYQATRVVVLSFELLNAPATVCGPKLSTQLVKNQCVNF
HKU3-13__Rhinolophus_sinicus	RVSPTQEVIRFPNITNRCPFDKVFNATRFPNVYAWERTKISDCVADYTVLYNS-TSFSTFKCYGVSPSKLIDLCFTSVYADTFLIRSSEVRQVAPGETGVIADYNYKLPDDFTGCVIAWNTAKHDT-----GNYYYRSHRKTKLKPFERDLSSDD-------------GNGVYTLSTYDFN-PNVPVAYQATRVVVLSFELLNAPATVCGPKLSTELVKNQCVNF
Rs4247__Rhinolophus_sinicus	RVSPTQEVIRFPNITNRCPFDKVFNASRFPNVYAWERTKISDCVADYTVLYNS-TSFSTFKCYGVSPSKLIDLCFTSVYADTFLIRSSEVRQVAPGETGVIADYNYKLPDDFTGCVIAWNTAKQDT-----GHYYYRSHRKTKLKPFERDLSSDD-------------GNGVYTLSTYDFN-PNVPVAYQATRVVVLSFELLNAPATVCGPKLSTQLVKNQCVNF
GX2013__Rhinolophus_sinicus	RVSPTQEVVRFPNITNRCPFDKVFNATRFPNVYAWERTKISDCVADYTVLYNS-TSFSTFKCYGVSPSKLIDLCFTSVYADTFLIRSSEVRQVAPGETGVIADYNYKLPDDFTGCVIAWNTAKQDT-----GNYYYRSHRKTKLKPFERDLSSDD-------------GNGVYTLSTYDFN-PNVPVAYQATRVVVLSFELLNAPATVCGPKLSTQLVKNQCVNF
Yunnan2011__Chaerephon_plicata	RVSPSTEVIRFPNITNRCPFDRVFNASRFPSVYAWERTKISDCVADYTVLYNS-TSFSTFKCYGVSPSKLIDLCFTSVYADTFLIRFSEVRQIAPGETGVIADYNYKLPDEFTGCVIAWNTANQDR-----GQYYYRSSRKTKLKPFERDLSSD--------------ENGVRTLSTYDFY-PSVPLEYQATRVVVLSFELLNAPATVCGPKLSTSLIKNQCVNF
MLHJC35__Rhinolophus_sinicus	RVSPSTEVVRFPNITNRCPFDRVFNASRFPSVYAWERTKISDCVADYTVLYNS-TSFSTFKCYGVSPSKLIDLCFTSVYADTFLIRSSEVRQVAPGETGVIADYNYKLPDEFTGCVIAWNTAKQDQ-----GQYYYRSSRKTKLKPFERDLSSD--------------ENGVRTLSTYDFY-PTVPIEYQATRVVVLSFELLNAPATVCGPKLSTQLIKNQCVNF
279-2005__Rhinolophus_macrotis	RVTPTQEVVRFPNITNRCPFDKVFNASRFPNVYAWERTKISDCVADYTVLYNS-TSFSTFKCYGVSPSKLIDLCFTSVYADTFLIRSSEVRQVAPGETGVIADYNYKLPDDFTGCVIAWNTAQQDQ-----GQYYYRSYRKEKLKPFERDLSSD--------------ENGVYTLSTYDFY-PSIPVEYQATRVVVLSFELLNAPATVCGPKLSTQLVKNQCVNF
Rp3__Rhinolophus_pearsonii	RVSPTQEVIRFPNITNRCPFDKVFNATRFPNVYAWERTKISDCVADYTVLYNS-TSFSTFKCYGVSPSKLIDLCFTSVYADTFLIRSSEVRQVAPGETGVIADYNYKLPDDFTGCVIAWNTAKQDQ-----GQYYYRSHRKTKLKPFERDLSSD--------------ENGVRTLSTYDFY-PSVPVAYQATRVVVLSFELLNAPATVCGPKLSTQLVKNQCVNF
Shaanxi2011__Rhinolophus_pusillus	RVSPTQEVVRFPNITNRCPFDKVFNATRFPSVYAWERTKISDCVADYTVLYNS-TSFSTFKCYGVSPSKLIDLCFTSVYADTFLIRSSEVRQVAPGETGVIADYNYKLPDDFTGCVIAWNTANQDQ-----GQYYYRSSRKEKLKPFERDLSSD--------------ENGVYTLSTYDFY-PSVPLDYQATRVVVLSFELLNAPATVCGPKLSTTLVKNQCVNF
Rs4081__Rhinolophus_sinicus	RVSPTHEVVRFPNITNRCPFDKVFNASRFPNVYAWERTKISDCVADYTVLYNS-TSFSTFKCYGVSPSKLIDLCFTSVYADTFLIRSSEVRQVAPGETGVIADYNYKLPDDFTGCVIAWNTAKQDQ-----GQYYYRSSRKTKLKPFERDLTSD--------------ENGVRTLSTYDFY-PNVPIEYQATRVVVLSFELLNAPATVCGPKLSTALVKNQCVNF
Rs4237__Rhinolophus_sinicus	RVSPTQEVIRFPNITNRCPFDKVFNASRFPNVYAWERTKISDCVADYTVLYNS-TSFSTFKCYGVSPSKLIDLCFTSVYADTFLIRSSEVRQVAPGETGVIADYNYKLPDDFTGCVIAWNTAKQDQ-----GQYYYRSSRKTKLKPFERDLSSD--------------ENGVRTLSTYDFY-PTVPIEYQATRVVVLSFELLNAPATVCGPKLSTGLVKNQCVNF
ATO98108__Aselliscus_stoliczkanus	RVSPTQEVVRFPNITNRCPFDKVFNATRFPSVYAWERTKISDCVADYTVLYNS-TSFSTFKCYGVSPSKLIDLCFTSVYADTFLIRSSEVRQVAPGETGVIADYNYKLPDDFTGCVIAWNTAQQDK-----GQYYYRSSRKTKLKPFERDLSSD--------------ENGVRTLSTYDFY-PTVPIEYQATRVVVLSFELLNAPATVCGPKLSTGLVKNQCVNF
YN2013__Rhinolophus_sinicus	RVSPTREVVRFPNITNRCPFDSIFNASRFPSVYAWERTKISDCVADYTVLYNS-TLFSTFKCYGVSPSKLIDLCFTSVYADTFLIRFSEVRQVAPGETGVIADYNYRLPDDFTGCVIAWNTANQDV-----GSYFYRSHRSTKLKPFERDLSSD--------------ENGVRTLSTYDFN-PNVPLDYQATRVVVLSFELLNAPATVCGPKLSTELVKNQCVNF
Rf4092__Rhinolophus_ferrumequium	RVQPTVDVVRFPNITNLCPFDAVFNATRFPSVYAWERVKISNCVADYTAFYNS-TSFSTFKCYGVSPSKLIDLCFTSVYADTFLIRFSEVRQVAPGETGVIADYNYKLPDDFTGCVIAWNTAKQDV-----GSYFYRSHRSSKLKPFERDLSSD--------------ENGVRTLSTYDFN-PNVPLDYQATRVVVLSFELLNAPATVCGPKLSTQLVKNQCVNF
ZXC21__Rhinolophus_sinicus	RVQPTQSIVRFPNITNVCPFHKVFNATRFPSVYAWERTKISDCIADYTVFYNS-TSFSTFKCYGVSPSKLIDLCFTSVYADTFLIRFSEVRQVAPGQTGVIADYNYKLPDDFTGCVIAWNTAKQDT-----GHYFYRSHRSTKLKPFERDLSSD--------------ENGVRTLSTYDFN-PNVPLEYQATRVVVLSFELLNAPATVCGPKLSTQLVKNQCVNF
ZC45__Rhinolophus_sinicus	RVQPTQSVVRFPNITNVCPFHKVFNATRFPSVYAWERTKISDCIADYTVFYNS-TSFSTFKCYGVSPSKLIDLCFTSVYADTFLIRFSEVRQVAPGQTGVIADYNYKLPDDFTGCVIAWNTAKQDV-----GNYFYRSHRSTKLKPFERDLSSD--------------ENGVRTLSTYDFN-PNVPLEYQATRVVVLSFELLNAPATVCGPKLSTQLVKNQCVNF
JL2012__Rhinolophus_ferrumequinum	RVQPTVDVARFPNITNVCPFDKVFNATRFPSVYAWERTKISDCVADYTVFYNS-TSFSTFNCYGVSPSKLIDLCFTSVYADTFLIRFSEVRQVAPGQTGVIADYNYKLPDDFIGCVIAWNTAKQDV-----GSYFYRSHRSSKLKPFERDLSSE--------------ENGVLTLSTYDFN-QNVPLEYQATRVVVLSFELLNAPATVCGPKLSTPLVKNQCVNF
273-2005__Rhinolophus_ferrumequium	RVSPVTEVVRFPNITNLCPFDKVFNATRFPSVYAWERTKISDCVADYTVFYNS-TSFSTFNCYGVSPSKLIDLCFTSVYADTFLIRFSEVRQVAPGQTGVIADYNYKLPDDFTGCVIAWNTAKQDV-----GSYFYRSHRSSKLKPFERDLSSV--------------EENGRTLSTYDFN-QNVPLEYQATRVVVLSFELLNAPATVCGPKLSTSLVKNQCVNF
Rf1__Rhinolophus_ferrumequium	RVSPVTEVVRFPNITNLCPFDKVFNATRFPSVYAWERTKISDCVADYTVFYNS-TSFSTFNCYGVSPSKLIDLCFTSVYADTFLIRFSEVRQVAPGQTGVIADYNYKLPDDFTGCVIAWNTAKQDV-----GSYFYRSHRSSKLKPFERDLSSE--------------ENGVRTLSTYDFN-QNVPLEYQATRVVVLSFELLNAPATVCGPKLSTSLVKNQCVNF
HeB2013__Rhinolophus_ferrumequium	RVSPVTEVVRFPNITNLCPFDKVFNATRFPSVYAWERTKISDCVADYTVFYNS-TSFSTFNCYGVSPSKLIDLCFTSVYADTFLIRFSEVRQVAPGQTGVIADYNYKLPDDFTGCVIAWNTAKQDV-----GSYFYRSHRSSKLKPFERDLSSE--------------ENGVRTLSTYDFN-QYVPLEYQATRVVVLSFELLNAPATVCGPKLSTSLVKNQCVNF
RhGB01__Rhinolophus_hipposideros	RVTPTTEVIRFPNVTQLCPFSDVFNRTMFPSVYAWERMSIRDCVADYAVLYNSSISFSTFECYGVSPTKLNDLCFSSVYADYFVVRGDDVKQIAPGKTGVIADYNYKLPDDFVGCVLAWNSRHVDN--KQ--GFYYRLFRHGKIKPYQRDMSRELYSPSGTPC-TVVGFNCYDPLAHYAFASPGIGIGYQPFRVVVLSFQLLNAPATVCGPKQSTDLVKNKCVNF
Khosta2__Rhinolophus_hipposideros	RVSPSLDVVRFPNMTNICPFDQVFNKTQFPSVYAWERVRISDCVSDYTVLYNSSASFSTFKCYGVSPTKLNDLCFSGVYADYFVVKGDHVHQIAPGQTGVIADYNYKLPSEFVGCILAWNTRTIDS--KR--GFYYRLFRHGNIRPYERDTSNVPYNAAGGTCNQPGTHNCYEPLQDYGFT-STSGVGYQPFRVVVLSFELLNAPATVCGPKQSTDLVKNKCVNF
Khosta1__Rhinolophus_ferrumequinum	RVSPSTEVVRFPNITNLCPFGQVFNASTFPSVYAWGRMRISDCVADYSVLYNSTSSFSTFKCYGVSPTKLNDLCFSSVYADYFVVKGDDVRQIAPAQTGVIADYNYKLPDDFTGCVLAWNTKSIDK--GQ--GFYYRLFRHGKIKPYERDTSNVPYNAQGGTCTDTSQLNCYQPLKSYDFT-DTVGVGYQPYRVVVLSFELLNAPATVCGPKQSTELVKNKCVNF
BtKY72__Rhinolophus	RVSPSTEVVRFPNITNLCPFGQVFNASNFPSVYAWERLRISDCVADYAVLYNSSSSFSTFKCYGVSPTKLNDLCFSSVYADYFVVKGDDVRQIAPAQTGVIADYNYKLPDDFTGCVLAWNTNSVDSKSGN--NFYYRLFRHGKIKPYERDISNVLYNSAGGTCSSISQLGCYEPLKSYGFT-PTVGVGYQPYRVVVLSFELLNAPATVCGPKKSTELVKNKCVNF
PRD-0038__Rhinolophus	RVSPSTEVVRFPNITNLCPFGQVFNASKFPSVYAWERLRISDCVADYSVLYNSSSSFSTFKCYGVSPTKLNDLCFSSVYADYFVVKGDDVRQIAPAQTGVIADYNYKLPDDFTGCVLAWNTNSVDSKQGN--NFYYRLFRHGKIKPYERDISNVLYNSAGGTCSSTSQLGCYEPLKSYGFT-PTVGVGYQPYRVVVLSFELLNAPATVCGPKKSTELVKNKCVNF
PRD-2386__Rhinolophus	RVSPSTEVVRFPNITNLCPFGQVFNASNFPSVYAWERLRISDCVADYSVLYNSSSSFSTFKCYGVSPTKLNDLCFSSVYADYFVVKGDDVRQIAPAQTGVIADYNYKLPDDFTGCVLAWNTNSVDSKQG---NFYYRLFRHGKIKPYERDISNVLYNSAGGTCSSISQLGCYEPLKSYGFT-PTVGVGYQPYRVVVLSFELLNAPATVCGPKKSTELVKNKCVNF
BB9904__Rhinolophus_euryale	RVTPTTEVVRFPNITKLCPFDQVFNASSFPSVYAWERVRITDCVANYAVLYNSSVSFSTFQCYGVSPTKLNDLCFSSVYADYFIVKGDDVRQIAPSQTGVIADYNYKLPDDFTGCVIAWNTNALDS--NK--DFYYRLFRHGKIKPYGRDLSNIPYSPSGTCS-TINNLNCFAPLKSYGFT-QSSGISFQPYRVVVLSFELLNAPATVCGPKQSTELVKDKCVNF
BM48-31__Rhinolophus_blasii	RVTPTTEVVRFPNITQLCPFNEVFNITSFPSVYAWERMRITNCVADYSVLYNSSASFSTFQCYGVSPTKLNDLCFSSVYADYFVVKGDDVRQIAPAQTGVIADYNYKLPDDFTGCVIAWNTNSLDS--SN--EFFYRRFRHGKIKPYGRDLSNVLFNPSGGTC-SAEGLNCYKPLASYGFT-QSSGIGFQPYRVVVLSFELLNAPATVCGPKQSTELVKNKCVNF
RaTG15__Rhinolophus_affinis	RVTPSQSVARYPNITNLCPFSQVFNATRFPSVYAWTRERISNCIADYSVLYNS-TSFSTFRCYGVSPTKLNDLCFSNVYADSMVVRGDEVRQIAPSQTGVIADYNYKLPDDFTGCVIAWNSKAKDE----NGQYFYRLFRKSKLLPFQRDVSNVTYGSGKNDGCNPSEADCYWPLLKYGFT-GSVSQDYQPYRVVVLSFELLNAPATVCGPKRSTELVYNKCVNF
RaTG13__Rhinolophus_affinis	RVQPTDSIVRFPNITNLCPFGEVFNATTFASVYAWNRKRISNCVADYSVLYNS-TSFSTFKCYGVSPTKLNDLCFTNVYADSFVITGDEVRQIAPGQTGKIADYNYKLPDDFTGCVIAWNSKHIDAKEGGNFNYLYRLFRKANLKPFERDISTEIYQAGSKPCNGQTGLNCYYPLYRYGFY-PTDGVGHQPYRVVVLSFELLNAPATVCGPKKSTNLVKNKCVNF
SARS_CoV-2__Homo_sapiens	RVQPTESIVRFPNITNLCPFGEVFNATRFASVYAWNRKRISNCVADYSVLYNS-ASFSTFKCYGVSPTKLNDLCFTNVYADSFVIRGDEVRQIAPGQTGKIADYNYKLPDDFTGCVIAWNSNNLDSKVGGNYNYLYRLFRKSNLKPFERDISTEIYQAGSTPCNGVEGFNCYFPLQSYGFQ-PTNGVGYQPYRVVVLSFELLHAPATVCGPKKSTNLVKNKCVNF
MP789__Manis_javanica	RVQPTESIVRFPNITNLCPFGEVFNATTFASVYAWNRKRISNCVADYSVLYNS-TSFSTFKCYGVSPTKLNDLCFTNVYADSFVVRGDEVRQIAPGQTGRIADYNYKLPDDFTGCVIAWNSNNLDSKVGGNYNYLYRLFRKSNLKPFERDISTEIYQAGSTPCNGVEGFNCYFPLQSYGFH-PTNGVGYQPYRVVVLSFELLKAPATVCGPKQSTNLVKNKCVNF
Rs4084__Rhinolophus_sinicus	RVAPSKEVVRFPNITNLCPFGEVFNATTFPSVYAWERKRISNCVADYSILYNS-TSFSTFKCYGVSATKLNDLCFSNVYADSFVVKGDDVRQIAPGQTGVIADYNYKLPDDFLGCVLAWNTNSKDSSTSGNYNYLYRWVRRSKLNPYERDLSNDIYSPGGQSCSA-VGPNCYNPLRPYGFF-TTAGVGHQPYRVVVLSFELLNAPATVCGPKLSTDLIKNQCVNF
Rs4231__Rhinolophus_sinicus	RVAPSKEVVRFPNITNLCPFGEVFNATTFPSVYAWERKRISNCVADYSVLYNS-TSFSTFKCYGVSATKLNDLCFSNVYADSFVVKGDDVRQIAPGQTGVIADYNYKLPDDFLGCVLAWNTNSKDSSTSGNYNYLYRWVRRSKLNPYERDLSNDIYSPGGQSCSA-IGPNCYNPLRPYGFF-TTAGVGHQPYRVVVLSFELLNAPATVCGPKLSTDLIKNQCVNF
RsSHC014__Rhinolophus_sinicus	RVAPSKEVVRFPNITNLCPFGEVFNATTFPSVYAWERKRISNCVADYSVLYNS-TSFSTFKCYGVSATKLNDLCFSNVYADSFVVKGDDVRQIAPGQTGVIADYNYKLPDDFLGCVLAWNTNSKDSSTSGNYNYLYRWVRRSKLNPYERDLSNDIYSPGGQSCSA-VGPNCYNPLRPYGFF-TTAGVGHQPYRVVVLSFELLNAPATVCGPKLSTDLIKNQCVNF
SARS_CoV__Homo_sapiens	RVVPSGDVVRFPNITNLCPFGEVFNATKFPSVYAWERKKISNCVADYSVLYNS-TFFSTFKCYGVSATKLNDLCFSNVYADSFVVKGDDVRQIAPGQTGVIADYNYKLPDDFMGCVLAWNTRNIDATSTGNYNYKYRYLRHGKLRPFERDISNVPFSPDGKPCTP-PALNCYWPLNDYGFY-TTTGIGYQPYRVVVLSFELLNAPATVCGPKLSTDLIKNQCVNF
CS24__Paradoxurus_hermaphroditus	RVVPSGDVVRFPNITNLCPFGEVFNATKFPSVYAWERKKISNCVADYSVLYNS-TFFSTFKCYGVSATKLNDLCFSNVYADSFVVKGDDVRQIAPGQTGVIADYNYKLPDDFMGCVLAWNTRNIDATSTGNYNYKYRYLRHGKLRPFERDISNVPFSPDGKPCTP-PAPNCYWPLNDYGFY-TTSGIGYQPYRVVVLSFELLNAPATVCGPKLSTDLIKNQCVNF
LYRa11__Rhinolophus_affinis	RVSPSKEVVRFPNITNLCPFGEVFNATTFPSVYAWERKRISNCVADYSVLYNS-TSFSTFKCYGVSAIKLNDLCFSNVYADSFVVKGDDVRQIAPGQTGVIADYNYKLPDDFMGCVLAWNTRNIDATSSGNFNYKYRSLRHGKLRPFERDISNVPFSPDGKPCTP-PAFNCYWPLNDYGFY-TTNGIGYQPYRVVVLSFELLNAPATVCGPKLSTDLITNQCVNF
LYRa3__Rhinolophus_affinis	RVSPSREVVRFPNITNLCPFGEVFNATTFPSVYAWERKRISNCVADYSVLYNS-TSFSTFKCYGVSAIKLNDLCFSNVYADSFVVKGDDVRQIAPGQTGVIADYNYKLPDDFMGCVLAWNTRNIDATSSGNFHYKYRSLRHGKLRPFERDISNVPFSPDGKPCTP-PAFNCYWPLNDYGFY-TTNGIGYQPYRVVVLSFELLNAPATVCGPKLSTDLITNQCVNF
WIV16__Rhinolophus_sinicus	RVAPSKEVVRFPNITNLCPFGEVFNATTFPSVYAWERKRISNCVADYSVLYNS-TSFSTFKCYGVSATKLNDLCFSNVYADSFVVKGDDVRQIAPGQTGVIADYNYKLPDDFTGCVLAWNTRNIDATQTGNYNYKYRSLRHGKLRPFERDISNVPFSPDGKPCTP-PAFNCYWPLNDYGFY-ITNGIGYQPYRVVVLSFELLNAPATVCGPKLSTDLIKNQCVNF
Rs3367__Rhinolophus_sinicus	RVAPSKEVVRFPNITNLCPFGEVFNATTFPSVYAWERKRISNCVADYSVLYNS-TSFSTFKCYGVSATKLNDLCFSNVYADSFVVKGDDVRQIAPGQTGVIADYNYKLPDDFTGCVLAWNTRNIDATQTGNYNYKYRSLRHGKLRPFERDISNVPFSPDGKPCTP-PAFNCYWPLNDYGFY-ITNGIGYQPYRVVVLSFELLNAPATVCGPKLSTDLIKNQCVNF
Rs7327__Rhinolophus_sinicus	RVAPSKEVVRFPNITNLCPFGEVFNATTFPSVYAWERKRISNCVADYSVLYNS-TSFSTFKCYGVSATKLNDLCFSNVYADSFVVKGDDVRQIAPGQTGVIADYNYKLPDDFMGCVLAWNTRNIDATSTGNYNYKYRSLRHGKLRPFERDISNVPFSPDGKPCTP-PAFNCYWPLNDYGFF-TTNGIGYQPYRVVVLSFELLNAPATVCGPKLSTDLIKNQCVNF
WIV1__Rhinolophus_sinicus	RVAPSKEVVRFPNITNLCPFGEVFNATTFPSVYAWERKRISNCVADYSVLYNS-TSFSTFKCYGVSATKLNDLCFSNVYADSFVVKGDDVRQIAPGQTGVIADYNYKLPDDFTGCVLAWNTRNIDATQTGNYNYKYRSLRHGKLRPFERDISNVPFSPDGKPCTP-PAFNCYWPLNDYGFY-ITNGIGYQPYRVVVLSFELLNAPATVCGPKLSTDLIKNQCVNF
