YN2013__Rhinolophus_sinicus	RVSPTREVVRFPNITNRCPFDSIFNASRFPSVYAWERTKISDCVADYTVLYNS-TLFSTFKCYGVSPSKLIDLCFTSVYADTFLIRFSEVRQVAPGETGVIADYNYRLPDDFTGCVIAWNTANQDVG-----SYFYRSHRSTKLKPFERDLSSDEN--------------GVRTLSTYDFNP-NVPLDYQATRVVVLSFELLNAPATVCGPKLSTELVKNQCVNF
Rf1__Rhinolophus_ferrumequium	RVSPVTEVVRFPNITNLCPFDKVFNATRFPSVYAWERTKISDCVADYTVFYNS-TSFSTFNCYGVSPSKLIDLCFTSVYADTFLIRFSEVRQVAPGQTGVIADYNYKLPDDFTGCVIAWNTAKQDVG-----SYFYRSHRSSKLKPFERDLSSE-E-------------NGVRTLSTYDFNQ-NVPLEYQATRVVVLSFELLNAPATVCGPKLSTSLVKNQCVNF
Rs4247__Rhinolophus_sinicus	RVSPTQEVIRFPNITNRCPFDKVFNASRFPNVYAWERTKISDCVADYTVLYNS-TSFSTFKCYGVSPSKLIDLCFTSVYADTFLIRSSEVRQVAPGETGVIADYNYKLPDDFTGCVIAWNTAKQDTG-----HYYYRSHRKTKLKPFERDLSSDDG-------------NGVYTLSTYDFNP-NVPVAYQATRVVVLSFELLNAPATVCGPKLSTQLVKNQCVNF
Rs4237__Rhinolophus_sinicus	RVSPTQEVIRFPNITNRCPFDKVFNASRFPNVYAWERTKISDCVADYTVLYNS-TSFSTFKCYGVSPSKLIDLCFTSVYADTFLIRSSEVRQVAPGETGVIADYNYKLPDDFTGCVIAWNTAKQDQG-----QYYYRSSRKTKLKPFERDLSSD-E-------------NGVRTLSTYDFYP-TVPIEYQATRVVVLSFELLNAPATVCGPKLSTGLVKNQCVNF
Rp3__Rhinolophus_pearsonii	RVSPTQEVIRFPNITNRCPFDKVFNATRFPNVYAWERTKISDCVADYTVLYNS-TSFSTFKCYGVSPSKLIDLCFTSVYADTFLIRSSEVRQVAPGETGVIADYNYKLPDDFTGCVIAWNTAKQDQG-----QYYYRSHRKTKLKPFERDLSSD-E-------------NGVRTLSTYDFYP-SVPVAYQATRVVVLSFELLNAPATVCGPKLSTQLVKNQCVNF
RhGB01__Rhinolophus_hipposideros	RVTPTTEVIRFPNVTQLCPFSDVFNRTMFPSVYAWERMSIRDCVADYAVLYNSSISFSTFECYGVSPTKLNDLCFSSVYADYFVVRGDDVKQIAPGKTGVIADYNYKLPDDFVGCVLAWNSRHVDNKQ----GFYYRLFRHGKIKPYQRDMSRELYSPSGTPC-TVVGFNCYDPLAHYAFASPGIGIGYQPFRVVVLSFQLLNAPATVCGPKQSTDLVKNKCVNF
BB9904__Rhinolophus_euryale	RVTPTTEVVRFPNITKLCPFDQVFNASSFPSVYAWERVRITDCVANYAVLYNSSVSFSTFQCYGVSPTKLNDLCFSSVYADYFIVKGDDVRQIAPSQTGVIADYNYKLPDDFTGCVIAWNTNALDS--NK--DFYYRLFRHGKIKPYGRDLSNIPYSPSGT-CSTINNLNCFAPLKSYGFTQ-SSGISFQPYRVVVLSFELLNAPATVCGPKQSTELVKDKCVNF
BM48-31__Rhinolophus_blasii	RVTPTTEVVRFPNITQLCPFNEVFNITSFPSVYAWERMRITNCVADYSVLYNSSASFSTFQCYGVSPTKLNDLCFSSVYADYFVVKGDDVRQIAPAQTGVIADYNYKLPDDFTGCVIAWNTNSLDS--SN--EFFYRRFRHGKIKPYGRDLSNVLFNPSGG-TCSAEGLNCYKPLASYGFTQ-SSGIGFQPYRVVVLSFELLNAPATVCGPKQSTELVKNKCVNF
Khosta2__Rhinolophus_hipposideros	RVSPSLDVVRFPNMTNICPFDQVFNKTQFPSVYAWERVRISDCVSDYTVLYNSSASFSTFKCYGVSPTKLNDLCFSGVYADYFVVKGDHVHQIAPGQTGVIADYNYKLPSEFVGCILAWNTRTIDSKR----GFYYRLFRHGNIRPYERDTSNVPYNAAGGTCNQPGTHNCYEPLQDYGFTS-TSGVGYQPFRVVVLSFELLNAPATVCGPKQSTDLVKNKCVNF
Khosta1__Rhinolophus_ferrumequinum	RVSPSTEVVRFPNITNLCPFGQVFNASTFPSVYAWGRMRISDCVADYSVLYNSTSSFSTFKCYGVSPTKLNDLCFSSVYADYFVVKGDDVRQIAPAQTGVIADYNYKLPDDFTGCVLAWNTKSIDKGQ----GFYYRLFRHGKIKPYERDTSNVPYNAQGGTCTDTSQLNCYQPLKSYDFTD-TVGVGYQPYRVVVLSFELLNAPATVCGPKQSTELVKNKCVNF
PRD-0038__Rhinolophus	RVSPSTEVVRFPNITNLCPFGQVFNASKFPSVYAWERLRISDCVADYSVLYNSSSSFSTFKCYGVSPTKLNDLCFSSVYADYFVVKGDDVRQIAPAQTGVIADYNYKLPDDFTGCVLAWNTNSVDSKQGN--NFYYRLFRHGKIKPYERDISNVLYNSAGGTCSSTSQLGCYEPLKSYGFTP-TVGVGYQPYRVVVLSFELLNAPATVCGPKKSTELVKNKCVNF
BtKY72__Rhinolophus	RVSPSTEVVRFPNITNLCPFGQVFNASNFPSVYAWERLRISDCVADYAVLYNSSSSFSTFKCYGVSPTKLNDLCFSSVYADYFVVKGDDVRQIAPAQTGVIADYNYKLPDDFTGCVLAWNTNSVDSKSGN--NFYYRLFRHGKIKPYERDISNVLYNSAGGTCSSISQLGCYEPLKSYGFTP-TVGVGYQPYRVVVLSFELLNAPATVCGPKKSTELVKNKCVNF
PRD-2386__Rhinolophus	RVSPSTEVVRFPNITNLCPFGQVFNASNFPSVYAWERLRISDCVADYSVLYNSSSSFSTFKCYGVSPTKLNDLCFSSVYADYFVVKGDDVRQIAPAQTGVIADYNYKLPDDFTGCVLAWNTNSVDSKQG---NFYYRLFRHGKIKPYERDISNVLYNSAGGTCSSISQLGCYEPLKSYGFTP-TVGVGYQPYRVVVLSFELLNAPATVCGPKKSTELVKNKCVNF
RaTG15__Rhinolophus_affinis	RVTPSQSVARYPNITNLCPFSQVFNATRFPSVYAWTRERISNCIADYSVLYNS-TSFSTFRCYGVSPTKLNDLCFSNVYADSMVVRGDEVRQIAPSQTGVIADYNYKLPDDFTGCVIAWNSKAKDE----NGQYFYRLFRKSKLLPFQRDVSNVTYGSGKNDGCNPSEADCYWPLLKYGFTG-SVSQDYQPYRVVVLSFELLNAPATVCGPKRSTELVYNKCVNF
SARS_CoV-2__Homo_sapiens	RVQPTESIVRFPNITNLCPFGEVFNATRFASVYAWNRKRISNCVADYSVLYNS-ASFSTFKCYGVSPTKLNDLCFTNVYADSFVIRGDEVRQIAPGQTGKIADYNYKLPDDFTGCVIAWNSNNLDSKVGGNYNYLYRLFRKSNLKPFERDISTEIYQAGSTPCNGVEGFNCYFPLQSYGFQP-TNGVGYQPYRVVVLSFELLHAPATVCGPKKSTNLVKNKCVNF
RaTG13__Rhinolophus_affinis	RVQPTDSIVRFPNITNLCPFGEVFNATTFASVYAWNRKRISNCVADYSVLYNS-TSFSTFKCYGVSPTKLNDLCFTNVYADSFVITGDEVRQIAPGQTGKIADYNYKLPDDFTGCVIAWNSKHIDAKEGGNFNYLYRLFRKANLKPFERDISTEIYQAGSKPCNGQTGLNCYYPLYRYGFYP-TDGVGHQPYRVVVLSFELLNAPATVCGPKKSTNLVKNKCVNF
Rs4231__Rhinolophus_sinicus	RVAPSKEVVRFPNITNLCPFGEVFNATTFPSVYAWERKRISNCVADYSVLYNS-TSFSTFKCYGVSATKLNDLCFSNVYADSFVVKGDDVRQIAPGQTGVIADYNYKLPDDFLGCVLAWNTNSKDSSTSGNYNYLYRWVRRSKLNPYERDLSNDIYSPGGQSCSA-IGPNCYNPLRPYGFFT-TAGVGHQPYRVVVLSFELLNAPATVCGPKLSTDLIKNQCVNF
SARS_CoV__Homo_sapiens	RVVPSGDVVRFPNITNLCPFGEVFNATKFPSVYAWERKKISNCVADYSVLYNS-TFFSTFKCYGVSATKLNDLCFSNVYADSFVVKGDDVRQIAPGQTGVIADYNYKLPDDFMGCVLAWNTRNIDATSTGNYNYKYRYLRHGKLRPFERDISNVPFSPDGKPCTP-PALNCYWPLNDYGFYT-TTGIGYQPYRVVVLSFELLNAPATVCGPKLSTDLIKNQCVNF
LYRa11__Rhinolophus_affinis	RVSPSKEVVRFPNITNLCPFGEVFNATTFPSVYAWERKRISNCVADYSVLYNS-TSFSTFKCYGVSAIKLNDLCFSNVYADSFVVKGDDVRQIAPGQTGVIADYNYKLPDDFMGCVLAWNTRNIDATSSGNFNYKYRSLRHGKLRPFERDISNVPFSPDGKPCTP-PAFNCYWPLNDYGFYT-TNGIGYQPYRVVVLSFELLNAPATVCGPKLSTDLITNQCVNF
Rs7327__Rhinolophus_sinicus	RVAPSKEVVRFPNITNLCPFGEVFNATTFPSVYAWERKRISNCVADYSVLYNS-TSFSTFKCYGVSATKLNDLCFSNVYADSFVVKGDDVRQIAPGQTGVIADYNYKLPDDFMGCVLAWNTRNIDATSTGNYNYKYRSLRHGKLRPFERDISNVPFSPDGKPCTP-PAFNCYWPLNDYGFFT-TNGIGYQPYRVVVLSFELLNAPATVCGPKLSTDLIKNQCVNF
WIV1__Rhinolophus_sinicus	RVAPSKEVVRFPNITNLCPFGEVFNATTFPSVYAWERKRISNCVADYSVLYNS-TSFSTFKCYGVSATKLNDLCFSNVYADSFVVKGDDVRQIAPGQTGVIADYNYKLPDDFTGCVLAWNTRNIDATQTGNYNYKYRSLRHGKLRPFERDISNVPFSPDGKPCTP-PAFNCYWPLNDYGFYI-TNGIGYQPYRVVVLSFELLNAPATVCGPKLSTDLIKNQCVNF
